0  0  0  8  0  0  0  0  0  0  0  0  0  0  0  0  0  0  0  0  0  5  2
8  8  0  0  8  0  0  0  0  0  0  0  0  0  0  0  0  0  0  0  0  5  
0  7  7  8  8  0  0  0  0  0  0  0  0  0  0  0  0  0  0  0  0  5  
0  0  0  7  7  0  0  0  0  0  0  0  0  0  0  0  0  0  0  0  0  5  
0  0  0  0  0  0  0  0  0  0  0  0  0  0  0  0  0  0  0  0  0  5  
0  0  0  0  5  5  5  0  0  0  0  0  0  0  0  0  0  0  0  0  0  5  
0  0  0  0  5  4  5  0  0  0  0  0  0  0  0  0  0  0  0  0  0  5  
0  0  0  0  0  4  0  0  0  0  0  0  0  0  0  0  0  0  0  0  0  5  
0  0  0  0  0  4  0  0  0  0  0  0  0  0  0  0  0  0  0  0  0  5  
