8  0  0  0  0  0  11  5
0  0  0  0  0  0  0  
0  0  0  0  0  0  0  
0  0  8  0  0  0  0  
0  0  0  0  0  0  0  
11  0  0  0  0  0  8  
