5  5  5  8  12  12  13  0  0  0  0  0  0  0  0  0  0  0  0  0  0  2
8  8  7  6  8  10  13  7  0  0  0  0  0  0  0  0  0  0  0  0  0  
13  7  7  8  8  11  7  7  0  0  0  0  0  0  0  0  0  0  0  0  0  
13  13  13  7  7  11  15  7  7  0  0  0  0  0  0  0  0  0  0  0  0  
0  0  0  4  4  11  11  7  7  0  0  0  0  0  0  0  0  0  0  0  0  
0  0  0  0  5  5  11  11  0  0  0  0  0  0  0  0  0  0  0  0  0  
0  0  0  0  5  4  5  11  0  0  0  0  0  0  0  0  0  0  0  0  0  
0  0  0  0  15  4  4  11  0  0  0  0  0  0  0  0  0  0  0  0  0  
0  0  0  0  15  4  4  11  11  0  0  0  0  0  0  0  0  0  0  0  0  
