5  5  5  8  12  12  13  0  0  0  0  0  0  0  0  0  0  0  0  0  0  5  2
8  8  7  6  8  10  13  0  0  0  0  0  0  0  0  0  0  0  0  0  0  5  
13  7  7  8  8  11  7  0  0  0  0  0  0  0  0  0  0  0  0  0  0  5  
13  13  13  7  7  11  15  0  0  0  0  0  0  0  0  0  0  0  0  0  0  5  
0  0  0  4  4  11  11  0  0  0  0  0  0  0  0  0  0  0  0  0  0  5  
0  0  0  0  5  5  5  0  0  0  0  0  0  0  0  0  0  0  0  0  0  5  
0  0  0  0  5  4  5  0  0  0  0  0  0  0  0  0  0  0  0  0  0  5  
0  0  0  0  15  4  4  0  0  0  0  0  0  0  0  0  0  0  0  0  0  5  
0  0  0  0  15  4  4  0  0  0  0  0  0  0  0  0  0  0  0  0  0  5  
