0  0  0  0  0  0  0  0  0  0  0  0  0  0  0  0  0  0  0  0  0  3
0  0  0  0  0  0  0  0  0  0  0  0  0  0  0  0  0  0  0  0  0  
0  0  0  0  0  0  0  0  0  0  0  0  0  0  0  0  0  0  0  0  0  
7  7  7  7  7  0  0  0  0  0  0  0  0  0  0  0  0  0  0  0  0  
4  4  4  4  4  7  7  7  7  0  0  0  0  0  0  0  0  0  0  0  0  
0  0  0  0  0  0  0  0  0  7  0  0  0  0  0  0  0  0  0  0  0  
0  0  0  0  0  0  0  0  0  0  7  7  7  0  0  0  0  0  0  0  0  
0  0  0  0  0  0  0  0  0  0  4  4  4  7  0  0  0  0  0  0  0  
0  0  0  0  0  0  0  0  0  0  4  4  4  4  7  7  7  7  0  0  0  
