0  0  0  0  0  0  0  0  0  0  0  0  0  0  0  2
0  0  0  7  7  7  7  7  7  7  7  0  0  0  0  
7  7  7  4  4  4  4  4  4  4  4  7  7  0  0  
4  4  4  4  4  4  11  11  11  4  4  4  4  0  0  
4  4  4  4  11  11  11  11  11  11  11  4  4  7  7  
4  4  4  11  11  11  11  11  11  11  11  11  4  4  4  
11  11  11  11  11  11  11  11  11  11  11  11  11  11  11  
11  11  11  11  11  11  11  11  11  11  11  11  11  11  11  
