4  4  4  5  0  0  0  2
8  8  9  7  7  0  0  
9  9  9  11  0  6  0  
0  0  0  0  6  9  0  
0  0  0  6  9  7  0  
